{
    "width": 20,
    "height": 11,
    "ban": {
        "x": 12,
        "y": 2
    },
    "locations": [
        ["e", "e", "e", "e", "w", "w", "w", "w", "w", "w", "w", "w", "e", "e", "e", "e", "e", "e", "e", "e"],
        ["e", "e", "e", "e", "w", "r", "r", "r", "r", "r", "r", "w", "w", "w", "w", "w", "w", "w", "w", "w"],
        ["w", "w", "w", "w", "w", "r", "w", "w", "w", "w", "r", "w", "r", "w", "w", "r", "r", "t", "t", "w"],
        ["w", "r", "b", "r", "r", "b", "r", "r", "r", "r", "r", "r", "r", "r", "r", "r", "r", "t", "t", "w"],
        ["w", "r", "r", "r", "w", "r", "w", "w", "w", "r", "w", "w", "w", "w", "w", "r", "r", "t", "t", "w"],
        ["w", "w", "w", "r", "w", "r", "w", "w", "w", "r", "w", "e", "e", "e", "w", "w", "w", "w", "w", "w"],
        ["e", "e", "w", "r", "r", "b", "r", "r", "b", "r", "w", "e", "e", "e", "e", "e", "e", "e", "e", "e"],
        ["e", "e", "w", "w", "w", "r", "r", "b", "w", "w", "w", "e", "e", "e", "e", "e", "e", "e", "e", "e"],
        ["e", "e", "e", "e", "w", "b", "r", "r", "w", "e", "e", "e", "e", "e", "e", "e", "e", "e", "e", "e"],
        ["e", "e", "e", "e", "w", "r", "r", "r", "w", "e", "e", "e", "e", "e", "e", "e", "e", "e", "e", "e"],
        ["e", "e", "e", "e", "w", "w", "w", "w", "w", "e", "e", "e", "e", "e", "e", "e", "e", "e", "e", "e"]
    ]
}
