{
	"width": 9,
	"height": 9,
	"ban": {
		"x": 1,
		"y": 1
	},
	"locations": [
		["e", "w", "w", "w", "w", "w", "e", "e", "e"],
		["e", "w", "r", "r", "r", "w", "w", "w", "w"],
		["e", "w", "r", "r", "r", "w", "r", "r", "w"],
		["e", "w", "w", "r", "r", "r", "r", "t", "w"],
		["w", "w", "w", "r", "w", "w", "w", "t", "w"],
		["w", "r", "b", "r", "w", "e", "w", "t", "w"],
		["w", "r", "b", "b", "w", "e", "w", "w", "w"],
		["w", "r", "r", "r", "w", "e", "e", "e", "e"],
		["w", "w", "w", "w", "w", "e", "e", "e", "e"]
	]
}