{
    "width": 10,
    "height": 9,
    "ban": {
        "x": 6,
        "y": 1
    },
    "locations": [
        ["e", "e", "e", "w", "w", "w", "w", "w", "w", "w"],
        ["e", "e", "e", "w", "r", "r", "r", "r", "r", "w"],
        ["w", "w", "w", "w", "r", "w", "r", "b", "r", "w"],
        ["w", "t", "t", "t", "b", "w", "b", "r", "w", "w"],
        ["w", "t", "t", "t", "r", "b", "r", "r", "r", "w"],
        ["w", "w", "w", "r", "b", "r", "w", "w", "r", "w"],
        ["e", "e", "w", "r", "b", "r", "r", "r", "r", "w"],
        ["e", "e", "w", "r", "r", "r", "r", "w", "w", "w"],
        ["e", "e", "w", "w", "w", "w", "w", "w", "e", "e"]
    ]
}
