{
    "width": 9,
    "height": 9,
    "ban": {
        "x": 7,
        "y": 1
    },
    "locations": [
        ["e", "w", "w", "w", "w", "w", "w", "w", "w"],
        ["e", "w", "r", "r", "w", "r", "r", "w", "w"],
        ["e", "w", "b", "r", "r", "b", "r", "r", "w"],
        ["e", "w", "r", "w", "w", "r", "b", "r", "w"],
        ["w", "w", "t", "t", "t", "b", "r", "w", "w"],
        ["w", "r", "t", "t", "t", "w", "r", "w", "e"],
        ["w", "r", "w", "b", "b", "r", "r", "w", "e"],
        ["w", "r", "r", "r", "r", "r", "r", "w", "e"],
        ["w", "w", "w", "w", "w", "w", "w", "w", "e"]
    ]
}
