 {
    "width": 10,
    "height": 8,
    "ban": {
        "x": 5,
        "y": 1
    },
    "locations": [
        ["e", "e", "e", "w", "w", "w", "w", "w", "e", "e"],
        ["w", "w", "w", "w", "r", "r", "r", "w", "w", "w"],
        ["w", "r", "r", "r", "r", "w", "r", "r", "r", "w"],
        ["w", "r", "b", "b", "r", "r", "w", "b", "r", "w"],
        ["w", "r", "r", "b", "w", "b", "r", "b", "r", "w"],
        ["w", "w", "w", "t", "t", "t", "b", "w", "w", "w"],
        ["e", "w", "t", "t", "t", "t", "r", "w", "e", "e"],
        ["e", "w", "w", "w", "w", "w", "w", "w", "e", "e"]
    ]
}
