{
    "width": 12,
    "height": 6,
    "ban": {
        "x": 8,
        "y": 1
    },
    "locations": [
        ["e", "w", "w", "w", "w", "w", "w", "w", "w", "w", "w", "e"],
        ["w", "w", "r", "r", "r", "r", "b", "r", "r", "r", "w", "w"],
        ["w", "r", "r", "b", "t", "t", "t", "t", "r", "b", "r", "w"],
        ["w", "r", "b", "r", "w", "w", "w", "w", "b", "r", "r", "w"],
        ["w", "w", "r", "r", "w", "e", "e", "w", "r", "r", "r", "w"],
        ["e", "w", "w", "w", "w", "e", "e", "w", "w", "w", "w", "w"]
    ]
}
