{
	"width": 11,
	"height": 9,
	"ban": {
		"x": 1,
		"y": 4
	},
	"locations": [
		["e", "e", "e", "e", "w", "w", "w", "e", "e", "e", "e"],
		["e", "e", "e", "e", "w", "t", "w", "w", "w", "e", "e"],
		["e", "e", "e", "e", "w", "r", "r", "r", "w", "e", "e"],
		["w", "w", "w", "w", "w", "b", "w", "r", "w", "w", "w"],
		["w", "r", "b", "r", "r", "t", "r", "r", "b", "t", "w"],
		["w", "w", "w", "w", "w", "b", "w", "w", "w", "w", "w"],
		["e", "e", "e", "e", "w", "r", "w", "e", "e", "e", "e"],
		["e", "e", "e", "e", "w", "t", "w", "e", "e", "e", "e"],
		["e", "e", "e", "e", "w", "w", "w", "e", "e", "e", "e"]
	]
}