{
	"width": 25,
	"height": 25,
	"ban": {
		"x": 12,
		"y": 12
	},
	"locations": [
		["e", "e", "e", "e", "e", "e", "e", "e", "e", "e", "e", "w", "w", "w", "e", "e", "e", "e", "e", "e", "e", "e", "e", "e", "e"],
		["e", "e", "e", "e", "e", "e", "e", "e", "e", "e", "e", "w", "t", "w", "e", "e", "e", "e", "e", "e", "e", "e", "e", "e", "e"],
		["e", "e", "e", "e", "e", "e", "e", "e", "e", "e", "e", "w", "r", "w", "e", "e", "e", "e", "e", "e", "e", "e", "e", "e", "e"],
		["e", "e", "e", "e", "e", "e", "e", "e", "w", "w", "w", "w", "r", "w", "w", "w", "w", "e", "e", "e", "e", "e", "e", "e", "e"],
		["e", "e", "e", "e", "e", "e", "e", "e", "w", "t", "r", "b", "r", "b", "r", "t", "w", "e", "e", "e", "e", "e", "e", "e", "e"],
		["e", "e", "e", "e", "e", "e", "e", "e", "w", "w", "w", "w", "r", "w", "w", "w", "w", "e", "e", "e", "e", "e", "e", "e", "e"],
		["e", "e", "e", "e", "e", "e", "e", "e", "e", "e", "e", "w", "r", "w", "e", "e", "e", "e", "e", "e", "e", "e", "e", "e", "e"],
		["e", "e", "e", "e", "e", "e", "e", "e", "e", "e", "e", "w", "r", "w", "e", "e", "e", "e", "e", "e", "e", "e", "e", "e", "e"],
		["e", "e", "e", "w", "w", "w", "e", "e", "e", "e", "e", "w", "r", "w", "e", "e", "e", "e", "e", "w", "w", "w", "e", "e", "e"],
		["e", "e", "e", "w", "t", "w", "e", "e", "e", "e", "e", "w", "r", "w", "e", "e", "e", "e", "e", "w", "t", "w", "e", "e", "e"],
		["e", "e", "e", "w", "r", "w", "e", "e", "e", "e", "e", "w", "r", "w", "e", "e", "e", "e", "e", "w", "r", "w", "e", "e", "e"],
		["w", "w", "w", "w", "b", "w", "w", "w", "w", "w", "w", "w", "b", "w", "w", "w", "w", "w", "w", "w", "b", "w", "w", "w", "w"],
		["w", "t", "r", "r", "r", "r", "r", "r", "r", "r", "r", "b", "r", "b", "r", "r", "r", "r", "r", "r", "r", "r", "r", "t", "w"],
		["w", "w", "w", "w", "b", "w", "w", "w", "w", "w", "w", "w", "b", "w", "w", "w", "w", "w", "w", "w", "b", "w", "w", "w", "w"],
		["e", "e", "e", "w", "r", "w", "e", "e", "e", "e", "e", "w", "r", "w", "e", "e", "e", "e", "e", "w", "r", "w", "e", "e", "e"],
		["e", "e", "e", "w", "t", "w", "e", "e", "e", "e", "e", "w", "r", "w", "e", "e", "e", "e", "e", "w", "t", "w", "e", "e", "e"],
		["e", "e", "e", "w", "w", "w", "e", "e", "e", "e", "e", "w", "r", "w", "e", "e", "e", "e", "e", "w", "w", "w", "e", "e", "e"],
		["e", "e", "e", "e", "e", "e", "e", "e", "e", "e", "e", "w", "r", "w", "e", "e", "e", "e", "e", "e", "e", "e", "e", "e", "e"],
		["e", "e", "e", "e", "e", "e", "e", "e", "e", "e", "e", "w", "r", "w", "e", "e", "e", "e", "e", "e", "e", "e", "e", "e", "e"],
		["e", "e", "e", "e", "e", "e", "e", "e", "w", "w", "w", "w", "r", "w", "w", "w", "w", "e", "e", "e", "e", "e", "e", "e", "e"],
		["e", "e", "e", "e", "e", "e", "e", "e", "w", "t", "r", "b", "r", "b", "r", "t", "w", "e", "e", "e", "e", "e", "e", "e", "e"],
		["e", "e", "e", "e", "e", "e", "e", "e", "w", "w", "w", "w", "r", "w", "w", "w", "w", "e", "e", "e", "e", "e", "e", "e", "e"],
		["e", "e", "e", "e", "e", "e", "e", "e", "e", "e", "e", "w", "r", "w", "e", "e", "e", "e", "e", "e", "e", "e", "e", "e", "e"],
		["e", "e", "e", "e", "e", "e", "e", "e", "e", "e", "e", "w", "t", "w", "e", "e", "e", "e", "e", "e", "e", "e", "e", "e", "e"],
		["e", "e", "e", "e", "e", "e", "e", "e", "e", "e", "e", "w", "w", "w", "e", "e", "e", "e", "e", "e", "e", "e", "e", "e", "e"]
	]
}