{
    "width": 7,
    "height": 8,
    "ban": {
        "x": 4,
        "y": 1
    },
    "locations": [
        ["w", "w", "w", "w", "w", "w", "w"],
        ["w", "r", "r", "w", "r", "r", "w"],
        ["w", "r", "b", "b", "b", "r", "w"],
        ["w", "r", "r", "b", "r", "r", "w"],
        ["w", "r", "b", "b", "b", "r", "w"],
        ["w", "t", "t", "w", "t", "t", "w"],
        ["w", "t", "t", "b", "t", "t", "w"],
        ["w", "w", "w", "w", "w", "w", "w"]
    ]
}
