{
    "width": 9,
    "height": 7,
    "ban": {
        "x": 3,
        "y": 1
    },
    "locations": [
        ["e", "w", "w", "w", "w", "w", "w", "w", "w"],
        ["e", "w", "r", "r", "r", "r", "r", "r", "w"],
        ["w", "w", "r", "r", "t", "t", "b", "r", "w"],
        ["w", "r", "r", "w", "t", "t", "w", "w", "w"],
        ["w", "r", "b", "b", "b", "w", "w", "e", "e"],
        ["w", "r", "r", "r", "r", "w", "e", "e", "e"],
        ["w", "w", "w", "w", "w", "w", "e", "e", "e"]
    ]
}
