{
	"width": 11,
	"height": 9,
	"ban": {
		"x": 8,
		"y": 1
	},
	"locations": [
		["w", "w", "w", "w", "w", "w", "w", "w", "w", "w", "w"],
        ["w", "r", "r", "r", "r", "r", "w", "r", "r", "r", "w"],
        ["w", "r", "b", "r", "r", "b", "r", "r", "b", "r", "w"],
        ["w", "w", "r", "w", "t", "t", "t", "w", "r", "w", "w"],
        ["e", "w", "r", "w", "t", "t", "t", "w", "r", "w", "e"],
        ["e", "w", "b", "r", "w", "w", "w", "r", "b", "w", "e"],
        ["e", "w", "r", "r", "r", "b", "r", "r", "r", "w", "e"],
        ["e", "w", "r", "r", "w", "w", "r", "r", "r", "w", "e"],
        ["e", "w", "w", "w", "w", "w", "w", "w", "w", "w", "e"]
	]
}