{
    "width": 8,
    "height": 8,
    "ban": {
        "x": 3,
        "y": 1
    },
    "locations": [
        ["w", "w", "w", "w", "w", "w", "w", "w"],
        ["w", "r", "r", "r", "r", "r", "r", "w"],
        ["w", "r", "r", "w", "b", "b", "r", "w"],
        ["w", "w", "r", "b", "r", "r", "w", "w"],
        ["e", "w", "r", "r", "b", "t", "w", "e"],
        ["e", "w", "w", "r", "t", "w", "w", "e"],
        ["e", "e", "w", "t", "t", "w", "e", "e"],
        ["e", "e", "w", "w", "w", "w", "e", "e"]
    ]
}
