{
	"width": 12,
	"height": 12,
	"ban": {
		"x": 6,
		"y": 3
	},
	"locations": [
		["e", "w", "w", "w", "w", "w", "w", "w", "w", "w", "e", "e"],
		["e", "w", "t", "t", "t", "t", "t", "t", "t", "w", "w", "w"],
		["w", "w", "b", "b", "b", "b", "b", "b", "b", "b", "t", "w"],
		["w", "t", "b", "r", "r", "r", "r", "r", "r", "b", "t", "w"],
		["w", "t", "b", "r", "w", "w", "w", "w", "r", "b", "t", "w"],
		["w", "t", "b", "r", "w", "g", "g", "w", "r", "b", "t", "w"],
		["w", "t", "b", "r", "w", "g", "g", "w", "r", "b", "t", "w"],
		["w", "t", "b", "r", "w", "w", "w", "w", "r", "b", "t", "w"],
		["w", "t", "b", "r", "r", "r", "r", "r", "r", "b", "t", "w"],
		["w", "t", "b", "b", "b", "b", "b", "b", "b", "b", "w", "w"],
		["w", "w", "w", "t", "t", "t", "t", "t", "t", "t", "w", "e"],
		["e", "e", "w", "w", "w", "w", "w", "w", "w", "w", "w", "e"]
	]
}