 {
    "width": 10,
    "height": 8,
    "ban": {
        "x": 8,
        "y": 4
    },
    "locations": [
        ["e", "e", "w", "w", "w", "w", "w", "w", "e", "e"],
        ["e", "e", "w", "t", "t", "t", "t", "w", "e", "e"],
        ["e", "e", "w", "r", "r", "t", "t", "w", "e", "e"],
        ["w", "w", "w", "b", "b", "w", "w", "w", "w", "w"],
        ["w", "r", "b", "r", "r", "r", "b", "r", "r", "w"],
        ["w", "r", "r", "r", "b", "r", "b", "r", "r", "w"],
        ["w", "w", "w", "r", "r", "r", "w", "w", "w", "w"],
        ["e", "e", "w", "w", "w", "w", "w", "e", "e", "e"]
    ]
}
