{
	"width": 10,
	"height": 9,
	"ban": {
		"x": 6,
		"y": 2
	},
	"locations": [
		["e", "e", "w", "w", "w", "w", "w", "w", "w", "e"],
		["e", "e", "w", "r", "r", "r", "r", "r", "w", "e"],
		["e", "e", "w", "r", "b", "r", "r", "r", "w", "e"],
		["w", "w", "w", "w", "w", "r", "w", "r", "w", "e"],
		["w", "r", "b", "r", "r", "r", "r", "r", "w", "e"],
		["w", "r", "r", "w", "b", "w", "w", "r", "w", "w"],
		["w", "t", "t", "b", "r", "r", "w", "r", "r", "w"],
		["w", "t", "t", "r", "r", "r", "r", "r", "r", "w"],
		["w", "w", "w", "w", "w", "w", "w", "w", "w", "w"]
	]
}